#5
grass.bmp, 0
tree.bmp, 1
dirt.bmp, 2
rock.bmp, 3
water.bmp, 4

#8
#8
3 4 4 4 4 4 4 4
3 0 2 2 2 2 4 4
3 0 0 0 0 2 2 4
3 0 1 1 1 1 2 4
3 0 0 1 1 1 2 4
3 0 0 0 0 2 2 4
3 0 0 0 2 2 4 4
3 3 3 3 3 4 4 4